25 25
100 100
4 10 10 10 10 10 10 10 10 10 10 10 10 10 10 10 10 10 10 10 10 10 10 10 5
8 2  2  2  2  2  2  2  2  2  2  2  2  2  2  2  2  2  2  2  2  2  2  2  9
8 2  2  2  2 12  2  2  2  2  2  2  2  2  2  2  2  2  2  2  2  2  2  2  9
8 2  2  2  2  2  2  2  2  2  2  2  2  2  2  2  2  2  2  2  2  2  2  2  9
8 2  2  2  2  2  2  2  2  12 12 2  2  2  2  2  2  2  2  2  2  2  2  2  9
8 2  2  2  2  2  2  2  2  12 12 2  2  2 12  2  2  2  2  2  2  2  2  2  9
8 2  2  2  2  2  2  2  2  2  2  2  2  2  2  2  2  2  2  2  2  2  2  2  9
8 2  2  2  2  2  2  2  2  2  2  2  2  2  2  2  2  2  2  2  2  2  2  2  9
8 2  2  2  2  2  2  2 12  2  2  2  2  2  2  2  2  2  2  2  2  2  2  2  9
8 2  2  2  2  2 12 12 12  2  2  2  2  2  2  2  2  2  2  2  2  2  2  2  9
8 2  2  2  2  2 12  2  2  2  2  2  2  2  2  2  2  2  2  2  2  2  2  2  9
8 2  2  2  2  2 12  2  2  2  2 12  2  2  2  2  2  2  2  2  2  2  2  2  9
8 2  2  2  2  2  2  2  2  2  2  2  2  2  2  2  2  2  2  2  2  2  2  2  9
8 2  2  2  2  2  2  2  2  2  2  2  2  2  2  2  2  2  2  2  2  2  2  2  9
8 2  2  2  2  2  2  2  2  2  2  2  2  2  2  2  2  2  2  2  2  2  2  2  9
8 2  2  2  2  2  2  2  2  2  2  2  2  2  2  2  2  2  2  2  2  2  2  2  9
8 2  2  2  2  2  2  2  2  2  2  2 12  2  2  2  2  2  2  2  2  2  2  2  9
8 2  2  2  2  2  2  2  2  2  2  2  2  2  2  2  2  2  2  2  2  2  2  2  9
8 2  2  2  2  2  2  2  2  2  2  2  2  2  2  2  2  2  2  2  2  2  2  2  9
8 2  2  2  2  2  2  2  2  2  2  2  2  2  2  2  2  2  2  2  2  2  2  2  9
8 2  2  2  2  2  2  2  2  12 2  2  2  2  2  2  2  2  2  2  2  2  2  2  9
8 2  2  2  2  2  2  2  2  2  2  2  2  2  2  2  2  2  2  2  2  2  2  2  9
8 2  2  2  2  2  2  2  2  2  2  2  2  2  2  2  2  2  2  2  2  2  2  2  9
8 2  2  2  2  2  2  2  2  2  2  2  2  2  2  2  2  2  2  2  2  2  2  2  9
7 11 11 11 11 11 11 11 11 11 11 11 11 11 11 11 11 11 11 11 11 11 11 11 6