25 25
100 100
4  10 10 10 10 10 10 5  12 12 12 12 12 4  10 10 10 10 6 12 12 12  6 10  5
8  1  1  1  8  2  9  7  10 10 5  12 12 5  1  1  1  1  7  10 10 10 6  1  9
8  1  1  1  8  2  9  1  1  1  7  10 10 6  1  12 1  9  8  1  1  1  1  1  9
8  1  1  1  8  2  9  12 12 1  12 1  1  1  1  12 1  7  6  1  12 12 4  11 12
8  11 11 11 6  1  9  1  1  1  1  1  4  11 11 5  1  1  1  1  1  1  7  11 9
8  1  1  1  1  1  9  1  12 11 11 11 9  1  9  8  1  4  5  1  1  1  12 1  9
8  1  1  1  1  1  9  1  1  9  4  10 6  1  9  8  1  9  8  1  1  1  1  1  9
7  10 10 10 5  1  9  12 1  9  8  1  1  1  9  6  1  7  6  1  1  1  12 1  9
12 12 12 12 9  1  9  1  1  7  6  1  12 1  12 1  1  1  1  1  1  1  12 1  9
12 12 12 12 9  1  9  1  4  1  1  1  12 1  1  4  11 5  1  9  12 4  5  1  9
12 12 12 12 9  1  9  1  7  12 1  12 7  11 11 9  12 8  1  1  9  12 8  9  9
12 12 4  10 6  1  1  1  1  1  1  12 4  6  1  7  10 6  1  9  12 10 6  1  9
12 4  6  1  1  1  12 1  12 1  12 10 8  1  1  12 1  1  1  1  1  1  12 1  9
12 8  1  1  11 12 12 1  12 1  1  1  8  1  4  5  1  11 1  4  5  1  12 1  9
12 8  1  4  8  1  1  1  12 1  12 12 12 1  9  8  12 10 1  9  8  1  12 1  9
4  6  1  7  8  1  12 1  12 1  1  1  1  1  9  8  1  12 1  9  8  1  1  1  9
8  1  1  1  8  1  1  1  12 12 12 1  12 1  7  6  1  12 1  9  8  1  9  11 6
7  5  12 1  8  1  4  5  1  1  1  1  12 1  1  1  1  12 1  1  12 1  1  9  12
12 8  1  1  8  1  9  6  1  12 11 11 6  12 12 1  12 10 5  1  12 12 9  12 12
12 8  1  12 10 1  9  1  1  1  1  9  1  1  1  1  1  1  9  5  1  1  1  7  5
12 8  1  1  1  1  9  5  1  9  1  9  5  1  12 1  12 12 7  6  1  12 1  1  9
12 7  5  1  4  5  12 8  1  9  1  7  6  1  12 1  1  1  1  12 1  4  1  1  9
12 12 8  1  7  6  1  7  5  1  1  1  1  4  6  1  4  5  1  1  1  9  7  11 6
12 12 8  1  1  1  1  1  7  11 11 11 11 6  7  12 9  8  1  1  4  12 7  12 12
7  12 7  11 11 11 11 11 12 12 12 12 12 12 12 12 6  7  11 11 6  12 12 12 6